1111111111000000000011100010001111111111
1111110010011100111001000000000110111000
1111000000000000000000000000000000000000
1110000000000111000000000000000000000000
00000000000001010000000000000000000@0000
0000000000000000000000011111000000111000
1000000000111111111100111111000001111100
1110000011111111111111111111111111111111
0000000000111111111100000000000000000000
0000000000001011010000000000001001000000
0000000000000000000000000000000000001110
0000000000000000000000000000000000000000
0000000000000000000000111111000000000000
0000010000000101000000111111000000011110
0001110000000101000001111111110000000000
1111111111111111111111111111111000111111
1111111111111111111111111111110000000000
0000000000111000111111111111100111111110
1100000011111000001100111111000011111100
1111001111111001011100011110000000000000
1111111111110000001100001100000011100000
1110011111111000011100000000000010011100
1000000010111000001101100001100000011100
1100000011111100111111110011111111111111
0000011111011100111000000000001111111111
0110000000011100000000000000001111000111
1110000000000000000000000000001100000111
0000000000000000000000000000001110010111
0000000000000000000000000111111100000011
0001100100000011000010000000001110010111
0001X001000011111100101^^000001100000011
1111111111111111111111111111111111010111
FAMW
CAVE
4
4
4
NONE
2


0