0000000000000000000000000000000000000000
0000000000000000000000000000000000000000
0000000000000000000000000000000000000000
0000000000000000000000000000000000000000
0000000000000000000000000000000000000000
0000000000000000000000000000000000000000
0000000000000000000000000000000000000000
0000000000000000000000000000000000000000
0000000000000000000000000000000000000000
0000000000000000000000000000000000000000
0000000000000000000000000000000000000000
0000000000000000000000000000000000000000
0000000000000000000000000000000000000000
0000000000000000000000000000000000000000
0000000000000000000000000000000000000000
0000000000000000000000000000000000000000
1111111111111111000000000000000000000000
1100000000000111000000000000000000000000
1000000000000011000000000000000000000000
0000000000000001000000000000000000000000
@00011^110000001000000000000000000000000
1111111111100011000000000000000000000000
1100000000000001000000000000000000000000
1000000000000001000000000000000000000000
0000000111000001000000000000000000000000
0000001111100011000000000000000000000000
1000111111111111000000000000000000000000
0000000000000001000000000000000000000000
0000000000000001000000000000000000000000
10000000000000X1000000000000000000000000
1100000000000111000000000000000000000000
1111111^^1111111000000000000000000000000
ANONYMOUS
CAVE
4
4
4
NONE
2


0