0000000000000000000000000000000000000000
0000000000000000000000000000000000000000
0000000000000000000000000000000000000000
0000000000000000000000000000000000000000
0000000000000000000000000000000000000000
0000000000000000000000000000000000000000
0000000000000000000000000000000000000000
0000000000000000000000000000000000000000
0000000000000000000000000000000000000000
0000000000000000000000000000000000000000
0000000000000000000000000000000000000000
0000000000000000000000000000000000000000
0000000000000000000000000000000000000000
0000000000000000000000000000000000000000
0000000000000000000000000000000000000000
0000000000000000000000000000000000000000
1111111111111111111000000000000000000000
1100000000000111111000000000000000000000
1000000000000011111000000000000000000000
0000000000000001111000000000000000000000
@00011^110000001111000000000000000000000
1111111111100001111000000000000000000000
1100000000000001111000000000000000000000
1000000000000001111000000000000000000000
0000000111000001111000000000000000000000
0000001111100011111000000000000000000000
0000111111111111111000000000000000000000
0000000000000001111000000000000000000000
0000000000000001111000000000000000000000
10000000000000X1111000000000000000000000
1100000000000111111000000000000000000000
1111111^^1111111111000000000000000000000
ANONYMOUS
CAVE
4
4
4
NONE
2


0
