0000000000000000000000000000000000000000
0000000000000000000000000000000000000000
0000000000000000000000000000000000000000
0000000000000000000000000000000000000000
0000000000000000000000000000000000000000
0000000000000000000000000000000000000000
0000000000000000000000000000000000000000
0000000000000000000000000000000000000000
0000000000000000000000000000000000000000
0000000000000000000000000000000000000000
0000000000000000000000000000000000000000
0000000000000000000000000000000000000000
0000000000000000000000000000000000000000
0000000000000000000000000000000000000000
0000000000000000000000000000000000000000
0000000000000000000000000000000000000000
0000000000000000000000000000000000000000
0000000000000000000000000000000000000000
1111111111111111110000000000000000000000
1111111111111111110000000000000000000000
1000000000000111110000000000000000000000
0000000000000011110000000000000000000000
@00011^110000001110000000000000000000000
1111111111100001110000000000000000000000
1100000000000001110000000000000000000000
1000000000000011110000000000000000000000
0000001111000111110000000000000000000000
0000111111111111110000000000000000000000
0000000000000001110000000000000000000000
10000000000000X1110000000000000000000000
1100000000000111110000000000000000000000
1111111^^1111111110000000000000000000000
ANONYMOUS
CAVE
4
4
4
NONE
2


0